                                        _      _____   _                       _               
     /\                                 | |    / ____| (_)                     | |              
    /  \     _ __     __ _   _ __     __| |   | (___    _  __   __   __ _    __| |   __ _   ___ 
   / /\ \   | '_ \   / _` | | '_ \   / _` |    \___ \  | | \ \ / /  / _` |  / _` |  / _` | / __|
  / ____ \  | | | | | (_| | | | | | | (_| |    ____) | | |  \ V /  | (_| | | (_| | | (_| | \__ \
 /_/    \_\ |_| |_|  \__,_| |_| |_|  \__,_|   |_____/  |_|   \_/    \__,_|  \__,_|  \__,_| |___/
                                                                                                
                                                                                                
